1111111111111
P000000000001
1000000000001
1000C00000000
1000000000001
1111111111111