1111111111111
P000000000001
1000000000001
10C000000000E
1000000000001
1111111111111