1111111111111
1000000001E01
10000000C0001
1000100000001
100000P000001
1111111111111
