1111111111111
10C000000CE01
10000000C1111
1000100000001
1CC000P000001
1100000000011
1100000000011
10C000000C001
10000000C1111
1000100000001
1CC0000000001
1111111111111

